2,4
0,0,0,0,0,0,0,0,0,0
0,0,0,0,0,0,0,0,0,0
0,0,1,0,1,0,0,0,0,0
0,1,1,1,1,1,1,0,0,0
0,1,1,1,1,1,1,0,0,0
0,1,1,1,0,1,0,0,0,0
0,1,1,1,1,1,0,0,0,0
0,0,0,0,6,0,0,0,0,0
0,0,0,0,8,10,12,1,0,0
0,0,0,0,0,0,0,0,0,0
0
0,0,0,0,0,0,0,0,0,0
0,0,0,0,0,0,0,0,0,0
0,0,4,0,0,0,0,0,0,0
0,0,0,5,0,0,0,0,0,0
0,0,0,6,7,0,0,0,0,0
0,0,0,0,0,0,0,0,0,0
0,0,0,0,0,0,0,0,0,0
0,0,0,0,0,0,0,0,0,0
0,0,0,0,0,0,0,1,0,0
0,0,0,0,0,0,0,0,0,0
0
0,0,0,0,0,0,0,0,0,0
0,0,0,0,0,0,0,0,0,0
0,0,0,0,0,0,0,0,0,0
0,0,0,2,0,0,0,0,0,0
0,0,0,0,0,2,0,0,0,0
0,0,2,0,0,2,0,0,0,0
0,0,0,0,0,0,0,0,0,0
0,0,0,0,0,0,0,0,0,0
0,0,0,0,0,0,0,0,0,0
0,0,0,0,0,0,0,0,0,0
0,0,0