4,2
0,0,0,0,0,0,0,0,0,0
0,0,0,0,0,0,0,0,0,0
0,0,21,21,21,0,0,0,0,0
0,0,21,21,21,21,0,0,0,0
0,0,21,21,21,21,0,0,0,0
0,0,0,21,21,21,21,10,12,0
0,0,0,21,21,21,21,0,14,0
0,0,0,0,21,21,21,0,21,0
0,0,0,0,0,0,0,0,0,0
0,0,0,0,0,0,0,0,0,0
10
0,0,0,0,0,0,0,0,0,0
0,0,0,0,0,0,0,0,0,0
0,0,0,0,0,0,0,0,0,0
0,0,0,0,0,0,0,0,0,0
0,0,0,0,6,7,0,0,0,0
0,0,0,0,0,8,0,0,0,0
0,0,0,0,0,0,0,0,0,0
0,0,0,0,0,0,0,0,1,0
0,0,0,0,0,0,0,0,0,0
0,0,0,0,0,0,0,0,0,0
0
0,0,0,0,0,0,0,0,0,0
0,0,0,0,0,0,0,0,0,0
0,0,0,0,0,0,0,0,0,0
0,0,0,12,0,0,0,0,0,0
0,0,0,2,2,0,0,0,0,0
0,0,0,0,0,0,0,0,0,0
0,0,0,0,2,12,0,0,0,0
0,0,0,0,0,0,0,0,0,0
0,0,0,0,0,0,0,0,0,0
0,0,0,0,0,0,0,0,0,0
0,0,0