4,6
0,0,0,0,8,1,0,0,0,0
0,0,0,0,6,0,0,0,0,0
0,0,0,1,1,0,0,0,0,0
0,0,1,1,1,1,1,0,0,0
0,0,1,1,1,1,1,0,0,0
0,0,1,1,1,0,0,0,0,0
0,0,0,0,1,6,6,6,0,0
0,0,0,0,0,0,0,6,0,0
0,0,0,0,0,0,0,6,0,0
0,1,10,10,10,8,8,8,0,0
1
0,0,0,0,0,13,0,0,0,0
0,0,0,0,0,0,0,0,0,0
0,0,0,0,0,0,0,0,0,0
0,0,0,0,0,0,0,0,0,0
0,0,4,5,6,0,0,0,0,0
0,0,0,0,0,0,0,0,0,0
0,0,0,0,0,0,0,0,0,0
0,0,0,0,0,0,0,0,0,0
0,0,0,0,0,0,0,0,0,0
0,1,0,0,0,0,0,0,0,0
0
0,0,0,0,0,0,0,0,0,0
0,0,0,0,0,0,0,0,0,0
0,0,0,0,0,0,0,0,0,0
0,0,0,0,0,0,0,0,0,0
0,0,0,2,2,2,0,0,0,0
0,0,0,0,0,0,0,0,0,0
0,0,0,0,0,0,0,0,0,0
0,0,0,0,0,0,0,0,0,0
0,0,0,0,0,0,0,0,0,0
0,0,0,0,0,0,0,0,0,0
0,0,0