4,0
3,3,3,3,3,3,3,3,3,3
3,3,3,3,3,3,3,3,3,3
3,3,2,2,2,2,2,2,3,3
3,3,2,2,2,2,2,2,3,3
2,2,2,2,2,2,2,2,21,21
3,3,2,2,2,2,2,2,3,3
3,3,2,2,2,2,2,2,3,3
3,3,2,2,2,2,2,2,3,3
3,3,3,3,3,3,3,3,3,3
3,3,3,3,3,3,3,3,3,3
8
0,0,0,0,0,0,0,0,0,0
0,0,0,0,0,0,0,0,0,0
0,0,0,0,0,0,0,0,0,0
0,0,0,0,0,0,0,0,0,0
0,0,0,0,0,0,0,0,0,1
0,0,0,0,0,0,0,0,0,0
0,0,0,0,0,0,0,0,0,0
0,0,0,0,0,0,0,0,0,0
0,0,0,0,0,0,0,0,0,0
0,0,0,0,0,0,0,0,0,0
0
0,0,0,0,0,0,0,0,0,0
0,0,0,0,0,0,0,0,0,0
0,0,2,0,2,0,2,0,0,0
0,0,0,2,0,2,2,2,0,0
0,0,0,0,2,2,0,0,0,0
0,0,2,0,0,0,0,2,0,0
0,0,0,2,0,0,0,0,0,0
0,0,2,0,2,0,2,0,0,0
0,0,0,0,0,0,0,0,0,0
0,0,0,0,0,0,0,0,0,0
0,0,0