6,0
15,15,15,15,15,15,15,15,15,15
15,15,15,15,15,15,15,15,15,15
15,15,15,15,15,15,15,15,15,15
15,15,15,15,15,15,15,15,15,15
15,15,15,15,15,15,15,15,15,15
15,15,15,15,15,15,15,15,15,15
15,15,15,15,15,15,15,15,15,15
15,15,15,15,15,15,15,15,15,15
15,15,15,15,15,15,15,15,15,15
15,15,15,15,15,15,15,15,15,15
3
0,0,0,0,0,0,0,0,0,0
0,0,0,0,0,0,0,0,0,0
0,0,0,0,0,0,0,0,0,0
0,0,0,0,0,0,0,0,0,0
0,0,0,0,0,0,0,0,0,0
0,0,0,0,0,0,0,0,0,1
0,0,0,0,0,0,0,0,0,0
0,0,0,0,0,0,0,0,0,0
0,0,0,0,0,0,0,0,0,0
0,0,0,0,0,0,0,0,0,0
0
10,0,10,0,0,0,0,0,0,11
0,0,0,0,0,0,0,0,0,0
0,0,0,0,0,0,0,0,0,0
0,0,0,0,0,0,0,0,0,0
0,10,0,0,0,0,0,0,0,0
0,0,0,0,0,0,0,0,0,0
0,0,0,0,0,0,0,0,0,11
0,0,0,10,0,0,0,0,0,0
0,0,0,0,0,0,0,0,0,0
0,0,0,10,0,0,0,0,11,0
0,0,0