4,0
0,0,0,0,0,0,0,0,0,0
0,0,0,0,0,0,0,0,0,0
15,15,0,15,15,15,0,15,15,15
0,15,15,15,0,15,15,15,15,15
15,15,15,15,0,15,15,15,0,15
15,15,0,15,15,15,15,15,15,15
15,15,15,15,0,15,15,15,15,15
0,15,15,15,15,15,15,15,15,15
0,0,0,0,0,0,0,0,0,0
0,0,0,0,0,0,0,0,0,0
4
0,0,0,0,0,0,0,0,0,0
0,0,0,0,0,0,0,0,0,0
14,0,0,0,0,0,0,0,0,0
0,0,0,0,0,0,0,0,0,0
0,0,0,0,0,0,0,0,0,0
0,0,0,0,0,0,0,0,0,1
0,0,0,0,0,0,0,0,0,0
0,0,0,0,0,0,0,0,0,0
0,0,0,0,0,0,0,0,0,0
0,0,0,0,0,0,0,0,0,0
0
0,0,0,0,0,0,0,0,0,0
0,0,0,0,0,0,0,0,0,0
0,0,0,0,0,2,0,0,2,0
0,0,0,0,0,0,0,0,2,0
0,0,0,0,0,2,0,2,0,0
0,0,0,0,11,2,0,2,2,0
0,0,2,0,0,0,2,2,2,2
0,0,0,0,2,0,0,2,0,2
0,0,0,0,0,0,0,0,0,0
0,0,0,0,0,0,0,0,0,0
0,0,0