4,0
1,1,1,3,3,3,3,1,6,1
1,1,1,2,2,2,2,1,6,1
1,1,1,2,2,2,2,1,6,1
1,1,1,2,2,2,2,1,6,1
1,1,1,2,2,2,2,1,6,1
1,1,1,2,2,2,2,1,6,1
1,1,1,2,2,2,2,1,6,1
1,1,1,2,2,2,2,1,6,1
1,1,1,2,2,2,2,1,6,1
1,1,1,3,3,3,3,1,6,1
8
0,0,0,0,0,0,0,0,0,0
0,0,0,0,0,0,0,0,0,0
0,0,0,0,0,0,0,0,0,0
0,0,0,0,0,0,0,0,0,0
0,0,0,0,0,4,0,0,0,0
0,0,0,0,0,0,0,0,0,1
0,0,0,0,0,0,0,0,0,0
0,0,0,0,0,0,0,0,0,0
0,0,0,0,0,0,0,0,0,0
0,0,0,0,0,0,0,0,0,0
0
3,0,0,0,0,0,0,0,0,3
0,0,0,0,0,0,2,0,0,3
0,0,0,2,0,0,0,0,0,0
0,0,0,0,0,0,0,0,0,0
0,0,0,2,0,0,0,0,0,0
0,0,0,0,0,0,0,0,0,0
0,0,2,0,0,0,0,0,0,0
0,0,0,0,0,0,0,0,0,0
0,0,0,0,0,2,0,0,0,3
3,0,0,0,0,0,0,0,0,3
0,0,0