1,1
1,1,1,1,1,1,1,1,1,1
1,1,1,1,1,1,1,1,1,1
1,1,1,1,1,1,1,1,1,1
1,1,1,1,1,1,1,1,1,1
1,1,1,1,1,1,1,1,1,1
1,1,1,1,1,1,1,1,1,1
1,1,1,1,1,1,1,1,1,1
1,1,1,1,1,1,1,1,1,1
1,1,1,1,1,1,1,1,1,1
1,1,1,1,1,1,1,1,1,1
0
0,0,0,0,0,0,0,0,0,0
0,0,0,0,0,0,0,0,0,0
0,0,0,0,0,0,0,0,0,0
0,0,0,0,0,0,0,0,0,0
0,0,0,0,0,0,0,0,0,0
0,0,0,0,0,0,0,0,0,0
0,0,0,0,0,0,0,0,0,0
0,0,0,0,0,0,0,0,0,1
0,0,0,0,0,0,0,0,0,0
0,0,0,0,0,0,0,0,0,0
0
9,9,9,9,9,9,9,9,9,9
0,0,9,9,9,9,9,9,0,0
0,0,2,0,0,2,0,0,0,0
0,0,9,2,0,0,0,9,0,0
0,0,9,0,2,0,0,9,0,0
0,0,9,0,0,0,0,9,0,0
0,0,9,0,0,0,0,9,0,0
0,0,9,0,0,0,0,9,0,0
0,0,2,2,2,0,0,9,0,0
9,9,9,9,9,9,9,9,9,9
0,0,0