4,0
3,3,3,3,3,3,3,3,3,3
3,3,3,21,3,3,3,3,3,3
3,3,3,3,3,3,3,3,3,3
21,21,2,2,2,2,2,21,21,21
21,21,2,2,2,2,2,21,21,21
21,21,2,2,2,2,2,21,21,21
21,21,2,2,2,2,2,21,21,21
3,3,3,3,3,3,3,3,3,6
3,3,3,21,21,21,3,3,3,6
3,3,3,3,3,3,3,3,3,21
10
0,0,0,0,0,0,0,0,0,0
0,0,0,13,0,0,0,0,0,0
0,0,0,0,0,0,0,0,0,0
0,0,0,0,0,0,0,0,0,0
0,0,0,0,0,0,0,0,0,0
0,0,0,0,0,0,0,0,0,0
0,0,0,0,0,0,0,0,0,0
0,0,0,0,0,0,0,0,0,0
0,0,0,4,0,0,0,0,0,0
0,0,0,0,0,0,0,0,0,1
0
0,0,0,0,0,0,0,0,0,0
0,0,0,0,0,0,0,0,0,0
0,0,0,0,0,0,0,0,0,0
0,2,2,0,0,2,0,0,0,0
0,0,0,2,2,0,0,0,0,0
0,0,2,2,0,2,0,0,0,0
0,0,0,2,2,0,0,0,0,0
0,0,0,0,0,0,0,0,0,0
0,0,0,0,0,0,0,0,0,0
0,0,0,0,0,0,0,0,0,0
0,0,0