1,0
1,1,1,1,1,1,1,1,1,1
1,1,1,1,3,3,3,1,1,1
1,1,1,1,3,3,3,1,1,1
1,1,1,1,3,3,3,3,3,3
1,1,1,1,3,3,3,3,3,3
1,1,1,1,1,1,3,3,3,3
1,1,1,1,3,3,3,3,3,3
1,1,1,1,3,3,3,1,1,1
1,1,1,1,3,3,3,1,1,1
1,1,1,1,1,1,1,1,1,1
0
0,0,0,0,0,0,0,0,0,0
0,0,0,0,0,0,0,0,0,0
0,0,0,0,0,0,0,0,0,0
0,0,0,0,0,0,0,0,0,0
0,0,0,0,0,0,0,0,0,0
0,0,0,0,0,0,0,0,0,0
0,0,0,0,0,0,0,0,0,0
1,0,0,0,0,0,0,0,0,0
0,0,0,0,0,0,0,0,0,0
0,0,0,0,0,0,0,0,0,0
0
9,9,9,9,9,9,9,0,0,0
0,0,0,2,0,0,0,0,2,0
0,0,2,2,0,0,0,0,2,2
0,0,2,0,0,0,0,0,0,0
0,0,0,0,0,0,0,0,0,0
9,9,9,9,9,9,0,0,0,0
0,0,0,0,0,0,0,0,0,0
0,0,0,0,0,0,0,2,0,0
0,0,0,0,0,0,0,2,2,0
9,9,9,9,9,9,9,0,0,0
0,0,0